# Crate Slot Channel Seg[0-27] ring[1-6] FF/BF
13 8 0 0 1   
13 8 1 0 2  
13 8 2 0 3  
13 8 3 0 4  
13 8 4 0 5C 
13 8 5 0 5L 
13 8 6 0 5R 
13 8 7 0 6  
13 9 0 1 1  
13 9 1 1 2  
13 9 2 1 3  
13 9 3 1 4  
13 9 4 1 5C 
13 9 5 1 5L 
13 9 6 1 5R 
13 9 7 1 6  
13 5 0 2 1  
13 5 1 2 2  
13 5 2 2 3  
13 5 3 2 4  
13 5 4 2 5C 
13 5 5 2 5L 
13 5 6 2 5R 
13 5 7 2 6  
13 6 0 3 1  
13 6 1 3 2  
13 6 2 3 3  
13 6 3 3 4  
13 6 4 3 5C 
13 6 5 3 5L 
13 6 6 3 5R 
13 6 7 3 6  
